WWWWWWWWWWWWWWWWWWWW
WWPTTTTTTTTTTTTTTTTW
WWSWWWWWWTWWWWWWWWTW
WWSWWWWWWTWWWWWWWWTW
WWDWWWWWWTWWWWWWWWTW
WWDWWWWWWTWWWWWWWWTW
WWDDDDDDDTTTETTTETTW
WWTWWWWWWWWSWWWWTWTW
WWTWTTTTTTTTTTTWTWDW
WWTWTTTTTTTTTTTWTWDW
WWTWTTTTTTTTTTTWTWDW
WWTWWWWWWWWTWWWWTWDW
WWTWWWWWWWWTWWWWTWDW
WWSWWWWWWWWSWWWWTWDW
WWSSTTTTTTTTTTTTTTTW
WWWWWWWWWWWWWWWWWWWW
WWWWWWWWWWWWWWWWWWWW