WWWWWWWWWWWWWWWWWWWWW
WPSTTTTTTTTTTTTTTTTTW
WDWWWTTWWWTTTTWWTTTTW
WDWWWTTWWWDDDDWWTTTTW
WDWTTTTDDDDSWWWWWWWTW
WDWWWSSWWWWWWWWWWWWTW
WDWWWTTDDDTTTTWWTTTTW
WDWWWTTDDDTTTTWWTTTTW
WDETTTTETTTTTTTTTTTTW
WTWWWSSWWWDSWWWWWWWTW
WTWWTTTTWWDTWWWWWWWTW
WSWWTTTTWWDTWWWWWWWTW
WSWWTTTTWWDTWWWWWWWTW
WTWWWSSWWWDTWWWWWWWTW
WTTTTTTTTTTTTTTTTTTTW
WWWWWWWWWWWWWWWWWWWWW
