WWWWWWWWWWWWWWWWWWWW
WPTTTTTSTTTSTTTTTTTW
WTWWWWTWTTTWTWWDWWTW
WTWTTTTWTTTWTWDDDWTW
WTWSSWDWTTTWTWWDWWTW
WTTTTWDWTTTWTWTTTTTW
WTWWWWDWWWWWTWTTTWDW
WTDDDDDTTTTTTTTTWTDW
WTWWWWTWWSWWTTTTTWDW
WTWETTTWTTTWTTTTTDDW
WTWWWWTWTTTWTTTWTDDW
WTWETTTWTTTWTTTWWWDW
WTWTTTTWTTTWTTTWDDDW
WTWWWWTWWWSWTTTTTTTW
WTTTTTTTTSTTTTTTTTTW
WWWWWWWWWWWWWWWWWWWW