WWWWWWWWWWWWWWWWWWWW
WDDDTTTTTTTDDDDDDDDW
WDWWWWWWWTTWWWWWWWDW
WDWWWWWWWTTWTTTTTWDW
WTTSTTTSTTTTTDDDTTDW
WTWWTTTWWTTWTTTTTWDW
WEWWWWWWWTTWWWWWWWEW
WTTTWTWTTTTTTTTTTTTW
WDDDWDWTTTTTTTTTTTTW
WDDDTSTTTTDWWWWWWWTW
WTTTTWTTTTDTTTTDDDTW
WSWWWWWWWTDDDDDTTTTW
WTTTTWTTTTTTTTTDDDTW
WDDDTWTTTTSWWWWWWWSW
WDDDTTTTTPSTTTTTTTSW
WWWWWWWWWWWWWWWWWWWW