WWWWWWWWWWWWWWWWWWWWW
WTTTTPTTTWWTTTSSSSTTW
WTWWWWDWWWWWWTWWWWTWW
WTWWWWTWWWWWWTSTTSTWW
WDWWWWDDTTTTDTWWWWTWW
WDWWWWSWWWTWWTWWWWTWW
WTTDTDTWWTWWTTTTTTTWW
WTWWWWWWWWTWWWWWWWTWW
WTWWWWWWTTTTTTWWWWWTW
WTTTTTTTTWWTWWTTTTTTW
WDWWWWTWTWETEWTWDWWWW
WTWWWWTWTWWTWWTWDWWWW
WTTTTTTTTTTTTTTTDTTTW
WWWWWWTWWWWWWTWWWWWWW
WDTTTTTTTWWTTTTTTTTTW
WDWWWWWWTWWTWWWTWWWTW
WDWWWWWWTWWTWWWSWWWTW
WDWWWWTTTTTWWTTTTWWTW
WDWWWWTWWWSWWWWSWWWTW
WDWWWWTWWWSWWWWTWWWTW
WDDDDDTTTTTTTTTTTTTTW
WWWWWWWWWWWWWWWWWWWWW
